111111111111111111111111
111111110000X00000000001
1111111100000000C0000001
10000000000X000000000001
10C00011111111C100000001
100000100000001000010001
10C00010001E100000010001
1000X0111111111110C10001
100000100000000000110X01
1111111111000000X0100001
100000000000000000100001
1P1111111111111111111001
111111111111111111111111
