111111111111111111111111
111111110000000000000001
111111110000000000000001
100000000000000000000001
10000011111111C100000001
100000100000000100010001
10000010000E000100010001
100000111111111110C10001
100000100000000000110001
111111111100000000100001
100000000000000000100001
1P1111111111111111111001
111111111111111111111111
