111111111111
1P00000XC001
1000E0C0T0C1
111111111111