1111111111111111111111111111111111111111
1P00000C0000C00000000000000000000000E111
1111111111111111111111111111111111111111