1111111111
1E10C00111
1100100011
10010P0001
111C00C001
1C00C00101
10X0CCX001
1C00C00X01
1111111111