111111111111
1100P00XC001
1E1001C000C1
111111111111