111111111111
1P00000XC011
1000E0C001C1
111111111111