111111111111
1P10000XC011
1100E0C000C1
111111111111