111111111111
1P00E00XC01
1000E0C000C1
111111111111