111111011111
1P00000XC001
1000E0C000C1
111111111111