111111111111
1P00000XC000
1000E0C000C1
111111111111