1111111111
10E0C00111
1000100011
10010P0001
111C00C001
1C00C00101
10X0CCX001
1C00C00X01
1111111111