1111111111
10E0C00111
1000100011
10010P0001
111C00C001
1C00C00101
1000CC0001
1C00C00001
1111111111