111111111111111
1000000000P0001
10000C000000001
10000000C000011
1000E0C000C0001
111111111111111