1111111111111111111111111111111111111111
1000000000000000000000000000000000000001
1000000000000000000000000000000000000001
100000000000000000E000000000000000000001
1000000000000000000000000000000000000001
1000000000000000000000000000000000000001
100000000000000X000000000000000000000001
100000000000000000000000X000000000000001
1000000000000000000000000000000000000001
1000000000000000000000000000000000000001
1000000000C000000P0000000000000000000001
1000000000000000000000000000000000000001
1000000000000000000000000000000000000001
1000000000C00000C00000000000000000000001
100000000000000000000000X000000000000001
1000000000000000000000000000000000000001
1000000000000000000000000000000000000001
100000000000000C000000000000000000000001
1000000000000000000000000000000000000001
1000000000000000000000000000000000000001
1000000000000000000000000000000000000001
1111111111111111111111111111111111111111