111111111111
1P00E00X0001
100000000001
111111111111