111111111111
1P00E00XC001
1000P0C000C1
111111111111